NO ./SRC/TEXTURES/blue_bricks.xpm
WE ./SRC/TEXTURES/red_bricks.xpm
SO ./SRC/TEXTURES/#panel.xpm
EA ./SRC/TEXTURES/#reddoor.xpm

C 102, 178,255
F 6,153 ,76

11111111111111111111111111111
11110111111111011100000010001
11110111111111011101010000001
11000000110101011100000010001
10000000100000001100000010001
1000E000000000001101010010001
1100000111010101111101111000111
11110111 1110101 101111010001
11111111 1111111 111111111111